-------------
-```````````-
-```````````-
-```````````-
-```````````-
-````-`-````-
-`````E`````-
-````-`-````-
-```````````-
-`-`-```-`-`-
-``E``F``E``-
-`-`-```-`-`-
-------------