-------------------------
-```````````-E````-````E---------
-```````````-```````````--EEEEEE-
-``````````````````````````````F-
-```````````-```````````--EEEEEE-
-```````````-E````-````E---------
-------------------------